11111
111111
10E101
11CC01
111111
111111