111111111
111111111
111111111
111111111
110ECP011
111111111
111111111