1111111
10ECP01
1111111
1111111