1111111
1111C11
10E1P11
11CC011
1111111
1111111