111111
111111
10ECP1
110001
111111
111111