111111
111111
10E1P1
11CC01
111111
111111