11100000111777
11110000011
1110000111177777777