1111111
1111111
10E1P11
11CC011
1111111
1111111