1111111111
10000C1111
1111101111
11111P1111
11111E1111
1111111111
