111111111111111111111111111111111111111111111111111111111111
1PCCCCCCCCCCCCCCCCCCCCCCCCCCCCCCCCCCCCCCCCCCCCCCCCCCCCC0C111
10C111111111111111111111111111111111111111111111111111110111
1CC1EC000000000000000000000000000000000000000000000000000001
111111111111111111111111111111111111111111111111111111111111