11111
1PCC1
11C11
11E11
11111
11111